R 800 600
SO	./assets/colorstone.xpm
WE	./assets/wood.xpm
EA	./assets/eagle.xpm
NO	./assets/redbricks.xpm
S	./assets/hitler.xpm

F	139, 90, 14
C	135, 206, 135

        1111111111111111111111111
        1000000000110000000000001
        1011000001110000002000001
        100100N000000000002000001
111111111011000001110000002000001
100000000011000001110111111111111
11110111111111011100000010001
11110111111111011101010010001
11002000110101011100000000001
100020000000S00000S0000010201
10000000000000001101020012221
1100000111010101111102111000111
11110111 1110101 101111010001
11111111 1111111 111111111111